SO /Users/zel-bouz/Desktop/42cub3D/textures/SO.png

WE /Users/zel-bouz/Desktop/42cub3D/textures/WE.png

NO /Users/zel-bouz/Desktop/42cub3D/textures/NO.png

EA /Users/zel-bouz/Desktop/42cub3D/textures/EA.png

F 255,255,255

C 0,0,255



        1111111111111111111111111
        1011000001110000000000001
        1000000000110000000000001
        1001000000000000000000001
11111111101100000111000000000N001
100000000011000001110111111111111
11110111111111011100000010001
1111111111111111111111111111111