SO /Users/idryab/Desktop/cub42Master/textures/WE.png
WE /Users/idryab/Desktop/cub42Master/textures/WE.png

NO /Users/idryab/Desktop/cub42Master/textures/WE.png

EA /Users/idryab/Desktop/cub42Master/textures/WE.png

C 32,52,68

F 116,160,151



1111111111111
1000000000001
1000000000001
100000E000001
1000000000001
1000000000001
1111111111111