NO ./textures/NO.png
SO ./textures/SO.png
WE ./textures/WE.png
EA ./textures/EA.png
F 90,100,100
C 0,0,0


11111111111111111111111111111111111111111
1     101          101          101     1
1    10001        10001        10001    1
1   1000001      1000001      1000001   1
1  100000001    100000001    100000001  1
1110000N000011110000000001111000000000111
10000000000000000000000000000000000000001
10000000000000000000000000000000000000001
11100000000011110000000001111000000000111
1  100000001    100000001    100000001  1
1   1000001      1000001      1000001   1
1    10001        10001        10001    1
1     101          101          101     1
11111111111111111111111111111111111111111
