EA /Users/idryab/Desktop/42cub/textures/EA.png
NO /Users/idryab/Desktop/42cub/textures/NO.png
SO /Users/idryab/Desktop/42cub/textures/SO.png
WE /Users/idryab/Desktop/42cub/textures/WE.png

C 175,168,237
F 0,0,0

        1111111111111111111111111
        1000000000110000000000001
        1011000001110000000000001
        1001000000000000000000001
111111111011000001110000000000001
100000000011000001110111111111111
11110111111111011100000010001    
11110111111111011101010010001
11000000110101011100000000001
10000000000000001100000000001
10000000000000001101010010001
11000001110101011111011110N0111111111111
11110111 1110101 111110100011
11111111 1111111 111111111111