SO /Users/zel-bouz/Desktop/42cub3D/textures/SO.png

WE /Users/zel-bouz/Desktop/42cub3D/textures/WE.png

NO /Users/zel-bouz/Desktop/42cub3D/textures/NO.png

EA /Users/zel-bouz/Desktop/42cub3D/textures/EA.png

F 255,255,255

C 0,0,255



1111111111111
10000N0000001
1111111111111