SO ./textures/SO3.png
WE ./textures/WE3.png
NO ./textures/NO3.png
EA ./textures/EA3.png

C 20,20,20

F 128,128,128

        1111111111111111111111111
        100000000011N000000000001
        10110000011100000000000001
111111111011000001110000000000001
100000000011000001110111111111111
11110111111111011100000010001
11110111111111011101010010001
11000000110101011100000010001
10000000000000001100000000001
10000000000000001101010010001
1100000111010101111101111000111
11110111 1110101 101111010001
11111111 1111111 111111111111